11111111111111111111
10000000100100000001
10000000100100010001
10000000000000010001
10000000000000000001
10000000000000000001
10000000100100000001
10000000100100000001
11111111100111111111
10000000000000000001
10000000000000000001
11111111100111111111
10000000100100000001
10000000100100000001
10000000000000000001
10010000000000000001
10000000000000000001
10000000100100000001
10000000100100000001
11111111111111111111
