11111111111111111111
10010000010000000001
10010000010000010001
10010011110000010001
10010000000000000001
10011111001111100001
10000000000010000001
10001110000000000001
10000000001111100001
10010000000000000001
10010000000000000001
10011111000111110001
10000000000000000001
10000000000000000001
11111111111111111111
